R 1920 1080

NO /home/makar/projects/school42/cub3d/rcs/textures/grey.xpm
SO /home/makar/projects/school42/cub3d/rcs/textures/blue.xpm
WE /home/makar/projects/school42/cub3d/rcs/textures/brick.xpm
EA /home/makar/projects/school42/cub3d/rcs/textures/wood.xpm
S /home/makar/projects/school42/cub3d/rcs/textures/barrel.xpm

F 79,79,79
C 83,138,207


        1111111111111111111111111
        1000000000110000000000001
        1011000001110000000000001
        1001000000000000000000001
111111111011000001110000000000001
100000000011000001110111111111111
11110111111111011100000010001
11110111111111011101010010001
11000000110101011100000010001
10000000010101011100000010001
10000000010101011100000010001
10002000000000001100000100001
10000200000000001101010010001
10000000000000001101010010001
10000000000000001101010010001
1100N0011101010111110111100111
11110111 1110101 101111010001
11111111 1111111 111111111111
